date,description,amount,balance
2024-01-05,"Client Payment Received","5000.00","5000.00"
2024-01-08,"AWS Services","-125.50","4874.50"
2024-01-12,"Office Supplies Purchase","-89.99","4784.51"
2024-01-15,"Google Ads Payment","-250.00","4534.51"
2024-01-18,"Gusto Payroll","-3200.00","1334.51"
2024-01-22,"Microsoft 365","-15.99","1318.52"